44444444444444444444444444444444444444444444444444444444444444444444444444444444444444444444444444444
4                                                                                                   4
4                                                                                                   4
4                                                                                                   4
4                                                                                                   4
4                                                                                                   4
4                                                                                                   4
4                                                                                                   4
4                                                                                                   4
4                                                                                                   4
4                                                                                                   4
4                                                                                                   4
4                                                                                                   4
4                                                                                                   4
4                                                                                                   4
4                                                                                                   4
4                                                                                                   4
4                                                                                                   4
4                                                                                                   4
4                                                                                                   4
4                                                                                                   4
4                                                                                                   4
4                                                                                                   4
4                                                                                                   4
4                                                                                                   4
4                                                                                                   4
4444444                                                                                             4
4     4                                                                                             4
4     4                                                                                             4
4     4                                                                                             4
4     4                                                                                             4
4     4                     D                               D                                       4
4     4                                               B                                             4
4     4                                                                                             4
4     4                                           BB                                                4
4     4                 D         B                           BBBB                                  4
4     4                       4                    BBB                                              4
4     4                    BB 4                 B                 BBB                               4
4     4                       4                                                                     4
4     4                   BBBBB                               BBB                                   4
4     4                 B                                                                           4
4     444444444444                                               BBBB                               4
4                4     BBB                                                                          4
4                4                          B                                                       4
4                4   BBB            BBBB                     444444444444444444444444444444444      4
4                4                                           4444444444444444444444444444444444     4
4                4                                           44444444444444444444444444444444444    4
4                4fffffffffffffffffffffffff4    4ffffffffffffFFFFFFFFFFFFFFFFFFFF4444444444444444   4
4                4FFFFFFFFFFFFFFFFFFFFFFFFF444444FFFFFFFFFFFFFFFFFFFFFFFFFFFFFFFF44444444444444444  4
4                4FFFFFFFFFFFFFFFFFFFFFFFFFFFFFFFFFFFFFFFFFFFFFFFFFFFFFFFFFFFFFFF44444444444444444  4
4                4FFFFFFFFFFFFFFFFFFFFFFFFF444444FFFFFFFFFFFFFFFFFFFFFFFFFFFFFFFF4                  4
4                444444444444444444444444444    4444444444444444444444444444444444                  4
4                                                                                                   4
4                                                                                                   4
4                                                                                                   4
4                                                                                                   4
4                                                                                                   4
4                                                                                           444444444
44444                                                                                      4444444444
4   4                                                                                     44FFFFFFFF4
4   4                                                                                    44FFFFFFFFF4
4   A                                                                                   44FFFFFFFFFF4
4C  A                                                                        E         444FFFFFFFFFF4
4444444444444                           44444444444444444444444444444444444444444444444444FFFFFFFFFF4
444444444444444444444444444444444444444444444444444444444444444444444444444444444444444444FFFFFFFFFF4
4FFFFFFFFFFFFFFFFFFFFFFFFFFFFFFFFFFFFFFFFFFFFFFFFFFFFFFFFFFFFFFFFFFFFFFFFFFFFFFFFFFFFFFFFFFFFFFFFFFF4
4FFFFFFFFFFFFFFFFFFFFFFFFFFFFFFFFFFFFFFFFFFFFFFFFFFFFFFFFFFFFFFFFFFFFFFFFFFFFFFFFFFFFFFFFFFFFFFFFFFF4
4FFFFFFFFFFFFFFFFFFFFFFFFFFFFFFFFFFFFFFFFFFFFFFFFFFFFFFFFFFFFFFFFFFFFFFFFFFFFFFFFFFFFFFFFFFFFFFFFFFF4
4FFFFFFFFFFFFFFFFFFFFFFFFFFFFFFFFFFFFFFFFFFFFFFFFFFFFFFFFFFFFFFFFFFFFFFFFFFFFFFFFFFFFFFFFFFFFFFFFFFF4
4FFFFFFFFFFFFFFFFFFFFFFFFFFFFFFFFFFFFFFFFFFFFFFFFFFFFFFFFFFFFFFFFFFFFFFFFFFFFFFFFFFFFFFFFFFFFFFFFFFF4
4FFFFFFFFFFFFFFFFFFFFFFFFFFFFFFFFFFFFFFFFFFFFFFFFFFFFFFFFFFFFFFFFFFFFFFFFFFFFFFFFFFFFFFFFFFFFFFFFFFF4
4FFFFFFFFFFFFFFFFFFFFFFFFFFFFFFFFFFFFFFFFFFFFFFFFFFFFFFFFFFFFFFFFFFFFFFFFFFFFFFFFFFFFFFFFFFFFFFFFFFF4
4FFFFFFFFFFFFFFFFFFFFFFFFFFFFFFFFFFFFFFFFFFFFFFFFFFFFFFFFFFFFFFFFFFFFFFFFFFFFFFFFFFFFFFFFFFFFFFFFFFF4
44444444444444444444444444444444444444444444444444444444444444444444444444444444444444444444444444444