"44444444444444444444444444444444444444444444444444444444444444444444444444444444444444444444444444444",
"4                                                   4                                               4", 
"4                                                   4                                               4",
"4                                                   4                                               4",
"4             4                                     4                                               4",
"4             4                                     4                                               4",
"4             4                                     4                                               4",
"4             4                                     4                                               4",
"4             4                                     4                                               4",
"4             4     Y                               4                                               4",
"4             4                                     4                                               4",
"4             4                                     4                                               4",
"4             4                    444444444444     4                                               4",
"4             4    444444444      44         Y4     4                                               4",
"4             4 J  4       4     44          Y4     4                                               4",
"4             444444       4                 Y4 444444444                                           4",
"4                          4W                Y4         4                                           4",
"4                          44444444444       Y4         4                                           4",
"4                                    4    44444         4                                           4",
"4                                    4        4   G G   4                                           4",
"4                                             4444444   4                                           4",
"4                  NN       G                 4         4                                           4",
"4               N          44444444333  N     4         4                                           4",
"4                                    3MMMMMMMM4     G G 4                                           4",
"4         NNN                        3333333334   4444444                                           4",
"4                       NN                              4                                           4",
"4                                                44444444                                           4",
"4    LNN               M    G  G G               4FFFFFF4                                           4",
"4                      33333333333          334  4FFFFFF4                                           4",
"4    MMMMMMMMMMMMMMMMMM3FFFFFFFFF3            3  4FFFFFF4                                           4",
"4    3333333333333333333FFFFFFFFF3            3FFFF444444                                           4",
"4                      33333333333            3FFFFFFFFF4                                           4",
"4                                             3FFFFFFFFF4                                           4",
"4                                   G G  G G  3444444444444444444444444444444444444444              4",
"4                             44433333333333333                                      4              4",
"4                             4                                                      4              4",
"4                     444444444                                                      4              4",
"44    4                4                                                              4             4",
"444  44                4                                                              4             4",
"4 4  4                 4                                                              4             4",
"4 4  4            444444                                                              4             4",
"4 4  4                                                                                4             4",
"4 4  4                                                                                4             4",
"4 4JJ4                                                                                4             4",
"4 4JJ4                                                                                4             4",
"4 4JJ4                                                                                4             4",
"4 4JJ4      4444444444444444444444                                                    4             4",
"4 4  4       44444444444444444444                                                     4             4",
"4 4  4        444444444444444444                                                      4             4",
"4 4  4                                                                                4             4",
"4 4  4                                                                                4             4",
"4 4  4                                                                                4             4",
"4 4  4                                                                                4             4",
"4 4  4                                  44444444                                      4             4",
"4 4  4             J                   44FFFFFF44                                     4             4",
"4 4  4MM G G G  G GJ G G GG G G       444FFFFFF444                                    4             4",
"4 4  444444444444444444444444444444444444444444444444               444444444         4             4",
"4 4                                                 4               4       4         4             4",
"4 4                                                 4               4       4   4444444             4",
"4 444444444444444444444444444444444444444444444444  4               4       4   4444444             4",
"4                                                4  4               4       4         4             4",
"4                                                4  4               4       4         4             4",
"4                                                4  4               4       4         4             4",
"4                                                4  4               4       4         4             4",
"4                                                4  4               4       44444     4             4",
"4                                                4  4               4       44444     4             4",
"4                                                4  4               4       4         4             4",
"4                                                4  4               4       4         4             4",
"4                                                4  4               4                 4             4",
"4                                                4  4MMMMMMMMMMMMMMM4                 4             4",
"4                                                4  44444444444444444       44444444444             4",
"4                                                4                          4                       4",
"4                                                4                    4444444                       4",
"44444444444444444444444444444444444444444444444444444444444444444444444444444444444444444444444444444",