
	"44444444444444444444444444444444444444444444444444444444444444444444444444444444444444444444444444444",
	"4                                                                                                   4",
	"4                                                                                                   4",
	"4                                                                                                   4",
	"4                                                                                                   4",
	"4                                                                                                   4",
	"4                                                                                                   4",
	"4                                                                                                   4",
	"4                                                                                                   4",
	"4                                                                                                   4",
	"4                                                                                                   4",
	"4                                                                                                   4",
	"4                                                                                                   4",
	"4                                                                                                   4",
	"4                                                                                                   4",
	"4                                                                                                   4",
	"4                                                                                                   4",
	"4                                                                                                   4",
	"4                                                                                                   4",
	"4                                                                                                   4",
	"4                                                                                                   4",
	"4                                                                                                   4",
	"4                                                                                                   4",
	"4                                                                                                   4",
	"4                                                                                                   4",
	"4                                                                                                   4",
	"4                                                                                                   4",
	"4                                                                                                   4",
	"4                                                                                                   4",
	"4       4444444444444444444444444444444444444444444444444444444444444444444444                      4",
	"4       4444444444444444444444444444444444444444444444444444444444444444444444                      4",
	"4       4444444444444444444444444444444444444444444444444444444444444444444444                      4",
	"4       4444444444444444444444444444444444444444444444444444444444444444444444             44444444 4",
	"4       4444444444444444444444444444444444444444444444444444444444444444444444            44FFFFFF444",
	"4       4444444444444444444444444444444444444444444444444444444444444444444444            4FFFFFFFFF4",
	"4       4444444444444444444444444444444444444444444444444444444444444444444444            4FFFFFFFFF4",
	"4       4444444444444444444444444444444444444444444444444444444444444444444444            4FFFFFFFFF4",
	"4       4444444444444444444444444444444444444444444444444444444444444444444444            4FFFFFFFFF4",
	"44444   4444444444444444444444444444444444444444444444444444444444444444444444            4FFFFFFFFF4",
	"4   4   444444444444444444444444444444444444444444444444                                  4FFFFFFFFF4",
	"4   4   444444444444444444444444444444444444444444444444                                  4FFFFFFFFF4",
	"4   4   444444444444444444444444444444444444444444444444    BBB                           4FFFFFFFFF4",
	"4   4   444444  44444444  444444444                44444   B444                           4FFFFFFFFF4",
	"4   4   444444  BBBBBBBB  44444444                 BBBBB   4444              W            4FFFFFFFFF4",
	"4   4   BBBBBB            BBBBBBB    4444444444                         443333            4FFFFFFFFF4",
	"4   4              Y                 4444444  Y              Y         4F43333            4FFFFFFFFF4",
	"4   4444444444444444444444444444444444444444444444444444444444444444444FF43333            4FFFFFFFFF4",
	"4       4FFFFFFFFFFFFFFFFFFFFFFFFFFFFFFFFFFFFFFFFFFFFFFFFFFFFFFFFFFFFFFFF43333            4FFFFFFFFF4",
	"4       4FFFFFFFFFFFFFFFFFFFFFFFFFFFFFFFFFFFFFFFFFFFFFFFFFFFFFFFFFFFFFFFF43333            4FFFFFFFFF4",
	"4       4FFFFFFFFFFFFFFFFFFFFFFFFFFFFFFFFFFFFFFFFFFFFFFFFFFFFFFFFFFFFFFFF43333            4FFFFFFFFF4",
	"4       4FFFFFFFFFFFFFFFFFFFFFFFFFFFFFFFFFFFFFFFFFFFFFFFFFFFFFFFFFFFFFFFF43333            4FFFFFFFFF4",
	"4       4444444444444444444444444444444444444444444444444444444444444444443333            4FFFFFFFFF4",
	"4                                                                                         4FFFFFFFFF4",
	"4                                                                                         4FFFFFFFFF4",
	"4                                                                                         4FFFFFFFFF4",
	"4                                                                                         4FFFFFFFFF4",
	"4                                                                                         4FFFFFFFFF4",
	"4                                                                                         4FFFFFFFFF4",
	"4                                                                                         4FFFFFFFFF4",
	"4                                                                  Y                      4FFFFFFFFF4",
	"4                                              4                                          4FFFFFFFFF4",
	"4                                             444              4                          4FFFFFFFFF4",
	"4                                            44444              4 4                       4FFFFFFFFF4",
	"4                       N        Y          4444444          N      4                     4FFFFFFFFF4",
	"4                                    N        Y                       4                   4FFFFFFFFF4",
	"d                4                       4444444444444                   4                4FFFFFFFFF4",
	"D               44fffffffffffffffffffffffffffffffffffffffffffffffffffffff44               4FFFFFFFFF4",
	"444444444444444444FFFFFFFFFFFFFFFFFFFFFFFFFFFFFFFFFFFFFFFFFFFFFFFFFFFFFFF444444444444444444FFFFFFFFF4",
	"4FFFFFFFFFFFFFFFFFFFFFFFFFFFFFFFFFFFFFFFFFFFFFFFFFFFFFFFFFFFFFFFFFFFFFFFFFFFFFFFFFFFFFFFFFFFFFFFFFFF4",
	"4FFFFFFFFFFFFFFFFFFFFFFFFFFFFFFFFFFFFFFFFFFFFFFFFFFFFFFFFFFFFFFFFFFFFFFFFFFFFFFFFFFFFFFFFFFFFFFFFFFF4",
	"4FFFFFFFFFFFFFFFFFFFFFFFFFFFFFFFFFFFFFFFFFFFFFFFFFFFFFFFFFFFFFFFFFFFFFFFFFFFFFFFFFFFFFFFFFFFFFFFFFFF4",
	"4FFFFFFFFFFFFFFFFFFFFFFFFFFFFFFFFFFFFFFFFFFFFFFFFFFFFFFFFFFFFFFFFFFFFFFFFFFFFFFFFFFFFFFFFFFFFFFFFFFF4",
	"4FFFFFFFFFFFFFFFFFFFFFFFFFFFFFFFFFFFFFFFFFFFFFFFFFFFFFFFFFFFFFFFFFFFFFFFFFFFFFFFFFFFFFFFFFFFFFFFFFFF4",
	"44444444444444444444444444444444444444444444444444444444444444444444444444444444444444444444444444444",